
4.
Persona = (DNI, Apellido, Nombre, Fecha_Nacimiento, Estado_Civil, Genero) 
Alumno = (DNI (fk), Legajo, Anio_Ingreso) 
Profesor = (DNI (fk), Matricula, Nro_Expediente) 
Titulo = (Cod_Titulo, Nombre, Descripcion) 
Titulo-Profesor = (Cod_Titulo (fk), DNI (fk), Fecha) 
Curso = (Cod_Curso, Nombre, Descripcion, Fecha_Creacion, Duracion) 
Alumno-Curso = (DNI (fk), Cod_Curso (fk), Anio, Desempenio, Calificacion) 
Profesor-Curso = (DNI (fk), Cod_Curso (fk), Fecha_Desde, Fecha_Hasta?) 

6.
Técnico = (codTec, nombre, especialidad)
Repuesto = (codRep, nombre, stock, precio)
RepuestoReparacion = (nroReparac (fk), codRep (fk), cantidad, precio) 
Reparación = (nroReparac, codTec (fk), precio_total, fecha) 

7.
Club = (codigoClub, nombre, anioFundacion, codigoCiudad(FK)) 
Ciudad = (codigoCiudad, nombre) 
Estadio = (codigoEstadio, codigoClub(FK), nombre, direccion) 
Jugador = (DNI, nombre, apellido, edad, codigoCiudad(FK)) 
ClubJugador = (codigoClub (FK), DNI (FK), desde, hasta)

8.
Equipo = (codigoE, nombreE, descripcionE)  
Integrante = (DNI, nombre, apellido, ciudad, email, telefono, codigoE(fk))  
Laguna = (nroLaguna, nombreL, ubicación, extension, descripción)  
TorneoPesca = (codTorneo, fecha, hora, nroLaguna(fk), descripcion) 
Inscripcion = (codTorneo(fk), codigoE(fk), asistio, gano)

9.
Proyecto = (codProyecto, nombrP,descripcion, fechaInicioP, fechaFinP?, 
fechaFinEstimada, DNIResponsable(FK), equipoBackend(FK), equipoFrontend(FK))        // DNIResponsable corresponde a un 
                                                                                    empleado, equipoBackend y equipoFrontend corresponden a equipos 
Equipo = (codEquipo, nombreE, descTecnologias, DNILider(FK))                        //DNILider corresponde a un empleado 
Empleado = (DNI, nombre, apellido, telefono, direccion, fechaIngreso) 
Empleado_Equipo = (codEquipo(FK), DNI(FK), fechaInicio, fechaFin, descripcionRol)

10.
Vehiculo = (patente, modelo, marca, peso, km) 
Camion = (patente(fk), largo, max_toneladas, cant_ruedas, tiene_acoplado) 
Auto = (patente(fk), es_electrico, tipo_motor) 
Service = (fecha, patente(fk), km_service, descripcion, monto) 
Parte = (cod_parte, nombre, precio_parte) 
Service_Parte = ([fecha, patente](fk), cod_parte(fk), precio)

11.
Box = (nroBox, m2, ubicación, capacidad, ocupacion) // ocupación es un numérico indicando cantidad 
de mascotas en el box actualmente, capacidad es una descripción. 
Mascota = (codMascota, nombre, edad, raza, peso, telefonoContacto) 
Veterinario = (matricula, CUIT, nombYAp, direccion, telefono) 
Supervision = (codMascota(fk), nroBox(fk), fechaEntra, fechaSale?, matricula(fk), descripcionEstadia) 
//fechaSale  tiene valor null si la mascota está actualmente en el box

12.
Barberia = (codBarberia, razon_social, direccion, telefono) 
Cliente = (nroCliente, DNI, nombYAp, direccionC, fechaNacimiento, celular) 
Barbero = (codEmpleado, DNIB, nombYApB, direccionB, telefonoContacto, mail) 
Atencion = (codEmpleado(fk), fecha, hora, codBarberia(fk), nroCliente(fk),
descTratamiento, valor) 

13.
Club = (IdClub, nombreClub, ciudad) 
Complejo = (IdComplejo, nombreComplejo, IdClub(fk)) 
Cancha = (IdCancha, nombreCancha, IdComplejo(fk)) 
Entrenador = (IdEntrenador, nombreEntrenador, fechaNacimiento, direccion) 
Entrenamiento = (IdEntrenamiento, fecha, IdEntrenador(fk), IdCancha(fk)) 